#################################################
#@.#............................................#
#...............................................#
####............................................#
#..........#....................................#
#...............................................#
#...............................................#
#...............................................#
#...............................................#
#...............................................#
#...............................................#
#...............................................#
#...............................................#
#...............................................#
#################################################